1111111111111111111111111
10000000000000C0000000001
1000000C00000000000000111
1000000000000000000000101
10000C0000000000E000001P1
1111111111111111111111111