111111111111111111111111111111
100000000000000000000000000001
100000000000000000000000000001
100000000000000000000000000001
100000000000000000000000000001
100000000000000000000000000001
100000000000000000000000000001
10000000000000000000C000000001
100000000000000000000000000001
10000000E000000000000000000001
100000000000000000000000000001
100000000000000000000000000001
1000000000000P0000000000000001
100000000000000000000000000001
100000000000000000000000000001
100000000000000000000000000001
100000000000000000000000000001
111111111111111111111111111111