111111111111111111111111111111
100001000000000000011111110001
100C0000000000000001C1C1C10C01
100001000000000000010101010001
111111000000000C00000000000001
100000000000000000000000000001
100000000000000000000000000001
10000000000000000000C111000111
100001000001000001000100000001
100C0100C00100E00100C10000C001
100001000001111111000100000001
100001111111111111111111000001
1000010000000P0000000001000001
1000010000C000000000C001000001
100001111110000000011111000001
1000C000000000C000000000000001
100000000000C1110000000C000001
111111111111111111111111111111