111111111111111111111111111111111111111111111111111111111111
1P00000000000C1000C00000111100000C0000000000000C111C111111C1
101111111111001000000000111100000000000000000000111000000001
101000000000011111111000111100111111111111111100111111011111
1010111111100C10000C00000000000000C000001C000000000000000111
101010C1C010011011111111100111111110111111111100111111111111
10C0101110100000000000000000000000000000000000000000000000C1
101010000010010110001111111110111111111100011100111111111101
101011010010010111C1111111111C11111111111C111C0000000000C101
101011010010010110001111111111111111111100011100111111110101
101000010010010000C0000000C11111C100000000000000111111110101
111110111110010111111011110100010110111111110000000000000001
11111011111001011111101111010E010000000000000000000000001101
100000000000000000000000000100010110111111110010001110001101
1C111111111001111111101111C11011C10000000000001C100C1000C101
10000000000000000000000001111C111100111111000011101110001101
110111111111C11111111111000110110000111111000000101C00001101
1101C0000000000000000000000000000000000000000000101110000001
1C0101101101110110000001111110111111C11111100000000000000101
11010110110111011C0000C1C00000000000000000000000000000000101
1100000C1100000111C11111111111111001111111111001111111111101
1111C11111C11100000000000000000000000000000000000000000000C1
111111111111111111111111111111111111111111111111111111111111