1111111111
1000000001
10EE00C001
1000000001
100P000001
1111111111