11111111
10000001
10E00001
10000C01
10000001
100P0001
10000001
11111111